AACDE|AACHEN
AALDE|AALEN
ABBDE|ABBENRODE
ABCDE|AUERBACH
ABSDE|ABSTATT
ACHDE|ACHERN
ADEDE|ADELZHAUSEN
AFFDE|AFFALTERBACH
AGDDE|AUENGRUND
AHADE|AHAUS
AHLDE|AHLEN
AHRDE|AHRENSBURG
AICDE|AICHALDEN
AINDE|AINRING
ALBDE|ALBSTADT
ALDDE|ALDINGEN
ALEDE|ALTENA
ALFDE|ALFDORF
ALHDE|ALTHENGSTETT
ALPDE|ALPIRSBACH
ALSDE|ALSDORF
ALTDE|ALTDORF
ALZDE|ALZENAU
AMBDE|AMBERG
ASCDE|ASCHAFFENBURG
ATKDE|ALTKIRCHEN
ATTDE|ATTENDORN
ATZDE|ATZENDORF
AUGDE|AUGSBURG
AUMDE|AUMA
AUSDE|AUSTORY
BAADE|BAD SAECKINGEN
BABDE|BAD BERLEBURG
BADDE|BAD HOMBURG
BAEDE|BADEN-WURTTEMBERG
BAHDE|BAHLINGEN
BAIDE|BAD AIBLING
BAMDE|BAMBERG
BARDE|BAAR-EBENHAUSEN
BASDE|BASANKIWTZ
BATDE|BAD TOELZ
BBADE|BADEN-BADEN
BBGDE|BREUBERG
BBHDE|BRAUNSBACH
BBNDE|BIETIGHEIM-BISSINGEN
BCHDE|BOCHUM
BCNDE|BUCHEN
BDEDE|BAD ENDBACH
BDNDE|BAD NEUSTADT
BDUDE|BAD DUBEN
BEBDE|BEBRA
BECDE|BECKUM
BEEDE|BIERE
BEGDE|BERG IM GAU
BEIDE|BREISACH
BELDE|BERLEBURG
BENDE|BENFIZHAUSEN
BERDE|BERLIN
BESDE|BESIGHEIM
BEXDE|BEXBACH
BHCDE|BAD URACH
BHMDE|BUCHHEIM
BHRDE|BAHRA
BIBDE|BITBURG
BIEDE|BIELEFELD
BIRDE|BITSTEIN
BITDE|BIETIGHEIM-BISSINGEN
BKBDE|BRUCHKOBEL
BKEDE|BRAKE
BKRDE|BAD KREUZNACH
BKZDE|BAD KOTZTING
BLADE|BLAICHACH
BLGDE|BALINGEN
BMNDE|BAD MUNSTEREIFEL
BMUDE|BAD MUNDER
BNSDE|BENSHEIM
BOBDE|BOBLINGEN
BOCDE|BOCKENEM
BODDE|BONDORF
BOEDE|BOEBLINGEN
BONDE|BONN
BORDE|BORDESHOLM
BRADE|BRAUNSCHWEIG
BRBDE|BIBERACH
BRDDE|BRECKERFELD
BREDE|BREMEN
BRGDE|BERG
BRIDE|BRIESELANG
BRKDE|BIRKENHAIN
BRODE|BROUGHTON
BRSDE|GERMANY
BRTDE|BRETTEN
BRUDE|BRUCHSAL
BRVDE|BREMERHAVEN
BSADE|BAD SACKINGEN
BSCDE|BAD SCHONBORN
BSDDE|BURSCHEID
BSSDE|BAD SODEN SALMUENSTER
BTEDE|BREITENHAIN
BUBDE|BURBACK-WAHLBACH
BUCDE|BUCKEBURG
BUDDE|BUDENHEIM
BUEDE|BUETTGEN
BUHDE|BUEHL
BUODE|BURO
BURDE|BURGES
BUXDE|BUXTEHUDE
BZWDE|BENZWEILER
CANDE|LANGHAGEN
CELDE|CELLE
CHEDE|CHEMNITZ
CHMDE|CHAM
CLODE|CLOPPENBURG
COBDE|COBURG
COLDE|COLOGNE
CREDE|CREGLINGEN
CRIDE|CRIMMITSCHAU
CUMBA|CUMBACH
DAADE|DAADEN
DACDE|DACHAU
DAMDE|DAMME
DARDE|DARMSTADT
DDFDE|DRIEDORF
DEAAH|AACHEN
DEAGB|MUNICH
DEAGE|WANGEROOGE
DEAOC|ALTENBURG
DEBBH|BARTH
DEBER|ACAPETAHUA
DEBFE|BIELEFELD
DEBGN|BRUEGGEN
DEBMK|BORKUM
DEBMR|BALTRUM ISLAND
DEBRE|BREMEN
DEBWE|BRAUNSCHWEIG
DEBYU|BAYREUTH
DECGN|COLOGNE
DEDRS|DRESDEN
DEDUS|DUSSELDORF
DEEIB|EISENACH
DEEME|EMDEN
DEERF|ERFURT
DEESS|ESSEN
DEEUM|NEUMUENSTER
DEFCN|CUXHAVEN
DEFDH|FRIEDRICHSHAFEN
DEFEL|FUERSTENFELDBRUCK
DEFKB|KARLSRUHE/BADEN BAD
DEFLF|FLENSBURG
DEFMM|MEMMINGEN
DEFMO|MUENSTER/OSNABRUECK
DEFNB|NEUBRANDENBURG
DEFRA|FRANKFURT
DEFRF|FRANKFURT
DEFRZ|FRITZLAR
DEGHF|GIEBELSTADT
DEGKE|GEILENKIRCHEN
DEGMY|RHEINDAHLEN
DEGTI|GUETTIN
DEGWT|WESTERLAND
DEGWW|ACAPETAHUA
DEHAJ|HANOVER
DEHAM|HAMBURG
DEHDB|HEIDELBERG
DEHDF|HERINGSDORF
DEHEI|HEIDE-BUESUM
DEHGL|HELGOLAND
DEHHN|HAHN
DEHOQ|HOF
DEIGS|INGOLSTADT-MANCHING
DEJUI|JUIST
DEKEL|KIEL
DEKLT|KAISERSLAUTERN
DEKOQ|KOETHEN
DEKZG|KITZINGEN
DELBC|LÃ¼BECK
DELDE|DELBRUECK
DELEJ|LEIPZIG-HALLE
DELGO|LANGEOOG
DELHA|LAHR
DELRC|LAARBRUCH
DEMGL|MOENCHENGLADBACH
DEMHG|MANNHEIM
DEMUC|MUNICH
DENDE|DENKLINGEN
DENDZ|NORDHOLZ-SPIEKA
DENOD|NORDEN
DENOE|NORDDEICH
DENRD|NORDERNEY
DENRN|DUSSELDORF
DEOBF|OBERPFAFFENHOFEN
DEOHR|WYK AUF FOEHR
DEPAD|PADERBORN
DEPEF|PEENEMUENDE
DEPHM|BOEBLINGEN
DEPSH|ST PETER
DEQDU|DUSSELDORF
DEQGV|FRANKFURT
DERBM|STRAUBING
DEREB|RECHLIN
DERLG|ROSTOCK-LAAGE
DERMS|RAMSTEIN
DESCN|SAARBRUECKEN
DESEX|SEMBACH
DESGE|SIEGEN
DESPM|SPANGDAHLEM
DESXF|ACAPETAHUA
DESZW|SCHWERIN
DETHF|ACAPETAHUA
DETXL|ACAPETAHUA
DEURD|BURG FEUERSTEIN
DEVAC|VARRELBUSCH
DEWBG|SCHLESWIG-JAGEL
DEWID|WILDENRATH
DEWIE|WIESBADEN
DEWVN|WILHELMSHAVEN
DEXFW|HAMBURG
DEXLW|LEMWERDER
DEXZE|RAIL
DEZAU|AUE
DEZCD|BAMBERG
DEZFR|FRANKFURT/ODER
DEZGA|GERA
DEZGE|GOERLITZ
DEZGO|GOTHA
DEZGW|GREIFSWALD
DEZHZ|HALLE
DEZIU|AACHEN
DEZJS|JENA
DEZSU|DESSAU
DEZTT|COTTBUS
DEZTZ|CHEMNITZ
DEZVM|HANOVER
DEZVR|HANOVER
DHNDE|DOHNA
DIBDE|DIEBURG
DIEDE|DIETZENBACH
DIFDE|DIEFURT
DILDE|DILLINGEN
DINDE|DINGOLFING
DIPDE|DIPPOLDISWALDE
DKDDE|DENKENDORF
DOMDE|DORMAGEN
DONDE|DONAUESCHINGEN
DORDE|DORTMUND
DRBDE|DREBA
DREDE|DRESDEN
DRKDE|DIERIKON
DRNDE|DORNSTADT
DTTDE|DETTINGEN
DURDE|DURBHEIM
DUSDE|DUSSELDORF
EBEDE|EBERN
EBHDE|EBHAUSEN
ECHDE|ECHING
ECKDE|ECKENBACH ALSENBORN
EDEDE|EDENKOBEN
EHNDE|EHNINGEN
EHRDE|EHRENKIRCHEN
EHSDE|EINHAUSEN
EIDDE|ESCHENBACH IN DER OBERPFALZ
EIIDE|EISINGEN
EINDE|EINBECK
EISDE|EISLINGEN
ELMDE|ELMSHORN
ELSDE|ELSTRA
ELTDE|ELTERLEIN
EMLDE|EMLEBEN
EMPDE|EMPFERTSHAUSEN
EMSDE|EMSBUREN
EMTDE|EBERMANNSTADT
ENGDE|ENGELSKIRCHEN
ENIDE|ENINGEN
ENKDE|ENKENBACH
ENNDE|ENNEPETAL
EPIDE|EPPINGEN
EPPDE|EPPELHEIM
ERDDE|ERDING
ERHDE|ERLIGHEIM
ERKDE|ERKELENZ
ERLDE|ERLANGEN
ERWDE|ERWITTE
ESCDE|ESCHBORN
ESLDE|ESSLINGEN
ESNDE|EISENACH
ESPDE|ESPELKAMP
ESSDE|ESSEN
ETEDE|ETTENHEIM
ETTDE|ETTLINGEN
EUSDE|EUSKIRCHEN
FBCDE|FISCHERBACH
FCNDE|FRECHEN
FDFDE|FRIEDRICHSDORF
FEIDE|FREILASSING
FELDE|FELDAFING
FIBDE|FREIBERG
FINDE|FINNENTROP
FISDE|FISCHACH
FKBDE|FRANKENBERG
FLBDE|FELLBACK
FLFDE|FRIDOLFING
FOHDE|FOHREN
FOIDE|FORITZ
FORDE|FORCHTENBERG
FRADE|FRANKFURT
FRBDE|FREIBURG
FRCDE|FRICKENHAUSEN
FREDE|FREUDENBERG
FRIDE|FRIEDRICHSHAFEN
FRSDE|FREISING
FUCDE|FUCHSMUEHL
FULDE|FULDA
GADDE|GARDELEGEN
GAGDE|GAGGENAU
GAIDE|GAIMERSHEIM
GALDE|GALIDORF
GARDE|GARCHING
GBNDE|GROEBENZELL
GDSDE|GEISLINGEN AN DER STEIGE
GEDDE|GEDERN
GEHDE|GEHREN
GEIDE|GEISELHOERING
GELDE|GELSENKIRCHEN
GENDE|GENGENBACH
GERDE|GERSTHOFEN
GESDE|GERNSBACH
GEVDE|GEVELSBERG
GIFDE|GIFHORN
GISDE|GEISINGEN
GLADE|GLADENBACH
GLDDE|GLADBECK
GLTDE|GLATTEN
GLUDE|GLAUBITZ
GOEDE|GOETTINGEN
GOSDE|GROSSBREITENBACH
GOTDE|GOETTINGEN
GPGDE|GOEPPINGEN
GRADE|GRASSAU
GREDE|GREVENBROICH
GRFDE|GRAFELFING
GRHDE|GRUNHAIN-BEIERFELD
GRNDE|GERNSHEIM
GRODE|GROSSBEEREN
GRSDE|GROSS-GERAU
GRTDE|GERETSRIED
GRUDE|GRUNDAU
GRVDE|GREVEN
GRZDE|GREIZ
GSCDE|GSCHWEND
GUEDE|GUETERSLOH
GUNDE|GUNDELSHEIM
GUSDE|GUSTAVSBURG
GWLDE|GOERWIHL
HAADE|HAAN
HAEDE|HAGENBACH
HAGDE|HAGEN
HAIDE|HAIGER
HALDE|HALLSTADT
HAMDE|HAMBURG
HANDE|HANNOVER
HARDE|HARMERSBACH
HASDE|HASSELROTH
HATDE|HATTINGEN
HAYDE|HAYNRODE
HDEDE|HERNE
HDHDE|HARDHEIM
HDSDE|HILDESHEIM
HEBDE|HERBOLZHEIM
HECDE|HECHINGEN
HEDDE|HERDORF
HEIDE|HEIDELBERG
HEMDE|HERMANNSBURG
HERDE|HERZOGENAURACH
HESDE|HESSDORF
HEUDE|HEUBACH
HGLDE|HAIGERLOCH
HIDDE|HIDDENHAUSEN
HILDE|HILDEN
HIRDE|HIRSCHBERG
HKLDE|HUCKELHOVEN
HKNDE|HANKENSBUETTEL
HLBDE|HEILBRONN
HLCDE|HILCHENBACH
HLLDE|HALLBERGMOOS
HMBDE|HEMSBACH
HMMDE|HAMM
HNADE|HANAU
HOCDE|HOCHSTADT
HOIDE|HOISDOF
HOLDE|HOLZGUENZ
HOMDE|HOMBURG
HRBDE|HERBORN
HRMDE|HEITERSHEIM
HRRDE|HERRSCHING
HRSDE|HIRSCHAID
HRTDE|HERTEN
HSNDE|HESSEN
HSSDE|HESSISCH OLDENDORF
HSTDE|HERRSTEIN
HTHDE|HARTHA
ICHDE|ICHTERSHAUSEN
IDADE|IDAR-OBERSTEIN
ILSDE|ILSENBURG
IMMDE|IMMENSTADT
INGDE|INGOLSTADT
ISEDE|ISERLOHN
ISNDE|ISERNHAGEN
ISPDE|ISPRINGEN
JENDE|JENA
KAADE|KAARST-BUTTGEN
KACDE|KALCHREUTH
KAIDE|KAISERSLAUTERN
KALDE|KARLSBAD-ITTERSBACK
KARDE|KARLSBAD-ITTERSBACH
KASDE|KASSEL
KCHDE|KIRCHHEIM
KCNDE|KIRCHEN
KEIDE|KIERSPE
KELDE|KELL AM SEE
KEMDE|KEMPTEN
KEPDE|KERPEN
KERDE|KERELD
KESDE|KEISTERBACH
KIEDE|KIERSPE
KIPDE|KIPPENHEIM
KIRDE|KIRCHLENGERN
KITDE|KITZINGEN
KMGDE|KORNTAL-MUENCHING
KNBDE|KONIGSBRUNN
KNIDE|KOENIGSTEIN
KNKDE|KONKEN
KNSDE|KOENIGSHEIM
KNZDE|KENZINGEN
KOBDE|KOBLENZ
KOCDE|KOCHEL
KOEDE|KOENIGSBACH-STEIN
KOLDE|KOLBERMOOR
KONDE|KONIGSBACH STEIN
KORDE|KORNWESTHEIM
KOSDE|KOSCHING
KOXDE|KOELN
KOZDE|KONZ
KRADE|KRAUTHAUSEN
KREDE|KREFELD
KRLDE|KARLSRUHE
KRNDE|KERNEN
KRODE|KRONACH
KRUDE|KRUMBACH
KSBDE|KELSTERBACH
KUEDE|KUERTEN
KUPDE|KUPFERZELL
KUSDE|KUSTERDINGEN
LAADE|LAAGE
LADDE|LAUDA KONIGSHOFEN
LAFDE|LAUFEN
LAGDE|LANGENLONSHEIM
LAHDE|LAHR
LAIDE|LAICHINGEN
LANDE|LANGENHAGEN
LAPDE|LAPPERSDORF
LAUDE|LAUBACH
LBNDE|LAUBEN
LDBDE|LAUDENBACH
LDSDE|LUDENSCHEID
LDWDE|LUDWIGSHAFEN
LEDDE|LEDERHOSE
LEIDE|LEIPZIG
LEMDE|LEMFORDE
LENDE|LENNESTADT
LEPDE|LEPPERSDORF
LETDE|LEUTERSDORF
LEUDE|LEUTENBACH
LEVDE|LEVERKUSEN
LGFDE|LAGENFELD
LGUDE|LANGENAU
LIADE|LINDENBERG IM ALLGAU
LICDE|LICHTENFELS
LINDE|LEINGARTEN
LIPDE|LIPPSTADT
LNDDE|LANDAU
LNGDE|LANGEN
LOADE|LORRACH
LOEDE|LOERRACH
LOHDE|LOHNE
LORDE|LORSCH
LOSDE|LOSSBURG
LOTDE|LOTTE
LOWDE|LOWENSTEIN
LSTDE|LANDSTUHL
LTNDE|LIECHTENSTEIN
LUDDE|LUDWIGSBURG
LUEDE|LUEDENSCHEID
MAIDE|MAINTAL
MAKDE|MARKTHEIDENFELD
MALDE|MALTERDINGEN
MANDE|MANNHEIM
MARDE|MARIENBERG
MAUDE|MAULBURG
MCHDE|MUNCHENBERNSDORF
MDNDE|MANDERN
MEBDE|MERBELSROD
MEEDE|MEERBUSCH
MELDE|MELLE
MENDE|MENDIG
MERDE|MERZENICH
METDE|METZINGEN
MFEDE|MORFELDEN-WALLDORF
MICDE|MICHELAU
MILDE|MILTENBERG
MLLDE|MELLRICHSTADT
MNCDE|MUNCHBERG
MOCDE|MONCHENGLADBACH
MOEDE|MOENCHENGLADBACH
MOHDE|MOHNESEE
MONDE|MONTOIR DE BRETAGNE
MOODE|MOOSTHENNING
MORDE|MORBACH
MOSDE|MOSSINGEN
MOZDE|MONZINGEN
MRKDE|MARKGROENINGEN
MRSDE|MERSEBURG
MSHDE|MAISACH
MUCDE|MUNCHEN
MUEDE|MUENCHEN
MULDE|MULHEIM
MUNDE|MUNICH
MUSDE|MUENSTER
MUTDE|MUTTERSTADT
NASDE|NASSAU
NAUDE|NAUHEIM
NDHDE|NORDRACH
NDODE|NEUSTADT AN DER ORLA
NEBDE|NEUBURG AN DER DONAU
NECDE|NECHARSULM
NEEDE|NEUENSTEIN
NEHDE|NEUHAUS-SCHIERSCHNITZ
NEIDE|NEU-ISENBURG
NENDE|NENTERSHAUSEN
NERDE|NERSINGEN
NESDE|NESSELWANG
NEUDE|NEU-ULM
NEUNK|NEUNKIRCHEN
NEWDE|NEUWIED
NHADE|NORDHAUSEN
NISDE|NEU ISENBURG
NKNDE|NEUKIRCHEN
NNBDE|NIENBURG
NNRDE|NEUENRADE
NORDE|NORDERSTEDT
NRDDE|NORDHEIM
NRWDE|NORTH RHINE-WETPHALIA
NSNDE|NECKARSTEINACH
NSSDE|NEUSS
NSTDE|NEUSTADT
NTGDE|NUERTINGEN
NTHDE|NORTHEIM
NUEDE|NUEMBURG
NUNDE|NEUENBURG
NURDE|NUREMBERG
OANDE|OBERNDORF AM NECKAR
OBEDE|OBERE
OBFDE|OBERPFAFFENHOFEN
OBGDE|OBRIGHEIM
OBHDE|OBERHAUSEN
OBNDE|OTTOBEUREN
OBRDE|OBER RAMSTADT
OBSDE|OBERSONTHEIM
ODBDE|OLDENBURG
OERDE|OBERDING-SCHWAIG
OFBDE|OFFENBURG
OFFDE|OFFENBACH
OGZDE|OBERGARTZEM
OHRDE|OHRINGEN
OLBDE|OLBERNHAU
OLPDE|OLPE
OPPDE|OPPACH
ORADE|ORANIENBURG
OREDE|OBERTRAUBLING
ORTDE|ORTENBERG
OSNDE|OSNABRUCK
OSSDE|OBERSCHLEISSHEIM
OSTDE|OSTFILDERN
OTBDE|OTTOBRUNN
OTEDE|OTTENSOOS
OTGDE|OESTRINGEN
OTTDE|OTTERSWEIER
PADDE|PADERBORN
PEIDE|PEITING
PENDE|PENZBERG
PETDE|PETERSHAGEN
PEZDE|PLIEZHAUSEN
PFODE|PFORZHEIM
PFRDE|PFRONTEN
PINDE|PEINE
PIRDE|PIRNA
PLEDE|PLETTENBERG
PLIDE|PLEIDELSHEIM
POLDE|POLLENFELD-PREITH
PTBDE|PETERSBURG
PUTDE|PUTZBRUNN
QUIDE|QUIDDELBACH
RADDE|RADEVORMWALD
RAHDE|RATHER STRABE
RANDE|RANSBACH-BAUMBACH
RATDE|RATINGEN
RAUDE|RAUNHEIM
RAVDE|RAVENSTEIN
RDMDE|ROEDERMARK
RDSDE|RENDSBURG
RDZDE|RADOLFZELL
REGDE|REGENSBURG
REHDE|REHBURG-LOCCUM
REIDE|REICHELSHEIM
REMDE|REMSCHEID
RENDE|RENFRIZHAUSEN
RESDE|ROESRATH
REUDE|REUTLIINGEN
RGNDE|REGEN
RHEDE|RHEINBOLLEN
RHFDE|RHEINFELDEN
RIEDE|RIEDEN AM FORGGENSEE
RINDE|RHEINAU
RIWDE|RIETHEIM-WEILHEIM
RMBDE|RIMBACH
RMGDE|REMAGEN
RMSDE|REMSHALDEN
RMTDE|RHEINMUNSTER
ROBDE|ROBWEIN
ROCDE|ROCKENHAUSEN
RODDE|RODGAU
ROEDE|ROETTINGEN
ROSDE|ROSENHEIM
ROTDE|ROTH
RSDDE|ROSDORF
RSFDE|ROSENFELD
RSSDE|ROSSDORF
RTHDE|ROTHENKIRCHEN
RTTDE|ROTTENBURG
RUEDE|RUESSELSHEIM
RUSDE|RUSSELSHEIM
RUTDE|RUTESHEIM
RWODE|RIELASINGEN-WORBLINGEN
SAADE|SAARBRUECKEN
SALDE|SALACH
SANDE|SANDERSDORF-BREHNA
SARDE|SAARLOUIS
SAWDE|SAARWELLINGEN
SBGDE|SULZBURG
SBHDE|STRAUBENHARDT
SBMDE|SCHWABMUNCHEN
SCADE|SCHWALMSTADT
SCEDE|SCHWELM
SCGDE|SCHROZBERG
SCHDE|SCHRAMBERG
SCIDE|SCHWEITENKIRCHEN
SCLDE|SCHLANGEN
SCMDE|SCHMALLENBERG
SCODE|SCHONACH
SCRDE|SCHORNDORF
SCUDE|SCHEUERFELD
SCWDE|SCHWEINA
SDSDE|STEINAU AN DER STRASSE
SECDE|SECKACH
SEEDE|SEEHEIM-JUGENHEIM
SEIDE|SEIFHENNERSDORF
SFLDE|STERNENFELS
SFSDE|SCHAFFHAUSEN
SGEDE|SANKT GEORGEN IM SCHWARZWALD
SHLDE|SCHLIERBACH
SHUDE|SCHUTTERAL
SHWDE|SCHEAIGERN
SIEDE|SIEGEN
SINDE|SINDELFINGEN
SKTDE|SALZKOTTEN
SLADE|SOHLAND
SLBDE|SELB
SLKDE|SCHMALKALDEN
SMLDE|SCHMELZ
SNFDE|SCHWEINFURT
SOHDE|SOHREN
SOLDE|SOLINGEN
SONDE|SONTHEIM
SOTDE|SONTRA
SPMDE|SCHOPFHEIM
SSGDE|SCHIEDER-SCHWALENBERG
STADE|STADTHAGEN
STDDE|STADTALLENDORF
STEDE|STEINBACH
STGDE|ST. GEORGEN
STNDE|STENDAL
STODE|STOLLBERG
STRDE|STRAUSBERG
STSDE|STEISSLINGEN
STUDE|STUTTGART
STZDE|STUTZENGRUN
SULDE|SULZBACH-ROSENBERG
SUNDE|SUNDERN
SUZDE|SULZBACH-LAUFEN
SWADE|SCHWALBACH AM TAUNUS
SWHDE|SCHWAIKHEIM
SWSDE|SCHWORSTADT
SWZDE|SCHWARZWALD
TAMDE|TAMBACH DIETHARZ
TAPDE|TAPPENBECK
TECDE|TECHAU
THUDE|THULBA
THYDE|THYRNAU
TOIDE|TROISDORF
TRADE|TRAUNREUT
TRBDE|TROSTBERG
TREDE|TREUCHTLINGEN
TRIDE|TRIBERG
TRODE|TROSSINGEN
TUBDE|TUBINGEN
TUTDE|TUTTLINGEN
UBEDE|UBERHERRN
UBSDE|UBSTADT-WEIHER
ULMDE|ULM
UMMDE|UMMENDORF
UNNDE|UNNA
UNTDE|UNTERFOHRING
URBDE|URBACH
UTEDE|UNTERGRUPPENBACH
UTMDE|UNTERMERZBACH
VEBDE|VELBERT
VELDE|VELTEN
VERDE|VERDEN AN DER ALLER
VIEDE|VIERNHEIM
VILDE|VILLINGEN SCHWENNINGEN
VIRDE|VIERSEN
VLSDE|VILSBIBURG
VNUDE|VIERNAU
VOGDE|VOGELBACH
WACDE|WACHAU
WAGDE|WAGHAEUSEL
WAKDE|WALDKRAIBURG
WALDE|WALLUF
WANDE|WANGEN
WBGDE|WESTERBURG
WBNDE|WIESBADEN
WEADE|WEIL AM RHEIN
WEDDE|WERDOHL
WEEDE|WEENER
WEIDE|WEINHEIM
WEKDE|WEIKERSHEIM
WELDE|WELZHEIM
WEMDE|WEMBACH
WENDE|WEIBENBURG
WERDE|WERNAU
WESDE|WESSELING
WETDE|WETTENBERG
WEYDE|WEYHE
WFHDE|WOLFRATSHAUSEN
WGTDE|WEINGARTEN
WHLDE|WIEHL
WIEDE|WIEBELSDORF
WILDE|WILLSTAETT
WINDE|WINTERBACH
WIPDE|WIPPERFURTH
WITDE|WITTEN
WLCDE|WIESLOCH
WLDDE|WALDERSHOF
WLLDE|WILLICH
WMBDE|WEUERTTEMBURG
WMDDE|WEMDING
WNDDE|WENDEN
WNNDE|WINNENDEN
WNTDE|WEISSENSTADT
WOLDE|WOLFSBURG
WRADE|WEIRA
WRNDE|WIERNSHEIM
WSBDE|WEISSENBURG IN BAYERN
WSDDE|WALLERSDORF
WSEDE|WESEL
WSTDE|WEINSTADT
WSZDE|WEISCHILTZ
WTSDE|WEITERSTADT
WTZDE|WETZLAR
WUEDE|WUELFRATH
WUPDE|WUPPERTAL
WURDE|WURZBURG
WUSDE|WUSTENROT
YKE|BRAKE
ZAHDE|ZELL AM HARMERSBACH
ZANDE|ZANDT
ZCKDE|ZWICKAU
ZELDE|ZELL
ZITDE|ZITTAU
ZWIDE|ZWIESEL