FRAGF     	AGEN
AIZFR     	AIZENAY
FRAJA     	AJACCIO
ALBFR     	ALBERT
FRLBI     	ALBI
FRAHZ     	ALPE D HUEZ
AMIFR     	AMIENS
ANDFR     	ANDREZIEUX
ANGFR     	ANGERS
FRANE     	ANGERS
ANOFR     	ANGOULEME
FRANG     	ANGOULEME
FRNCY     	ANNECY
ANEFR     	ANNECY-LE-VIEUX
ANNFR     	ANNEMASSE
ANTFR     	ANTEUIL
ARDFR     	ARDON
ARGFR     	ARGONAY
AROFR     	ARON
ARRFR     	ARRECIFE
ARZFR     	ARZAL
FRJAH     	AUBAGNE
FROBS     	AUBENAS
AUDFR     	AUDINCOURT
AURFR     	AURAY
FRAUR     	AURILLAC
AUXFR     	AUXERRE
FRAVN     	AVIGNON
FRXZN     	AVIGNON
FRAVF     	AVORIAZ
AVRFR     	AVRESSIEUX
AYTFR     	AYTRE
BAIFR     	BAIS
FRBAE     	BARCELONNETTE
FRMLH     	BASEL MULHOUSE FREI
BHMFR     	BASSE-HAM
FRBIA     	BASTIA
BAUFR     	BAUGE
BAVFR     	BAVANS
BEAFR     	BEAULIEU
BLRFR     	BEAUMONT LE ROGER
BNEFR     	BEAUNE 
FRBOR     	BELFORT
BELFR     	BELLEME
BLLFR     	BELLIGNAT
FREGC     	BERGERAC
BESFR     	BESANCON
FRBZR     	BEZIERS
FRBIQ     	BIARRITZ
BIEFR     	BIERNE
BILFR     	BILLY-BERCLAU
BLAFR     	BLANQUEFORT
BLOFR     	BLOIS
BOHFR     	BOHAIN EN VERMANDOIS
BOIFR     	BOIS-COLOMBES
BONFR     	BONDOUFLE
BORFR     	BORDEAUX
FRZFQ     	BORDEAUX
BODFR     	BORDERES
BOUFR     	BOUCONVILLERS
BOLFR     	BOULOGNE BILLANCOURT
FRBOU     	BOURGES
BRGFR     	BOURGOIN-JALLIEU
BREFR     	BRENOUILLE
FRBES     	BREST
BLSFR     	BREUIL LE SEC
BRIFR     	BRIERES LES SCELLES
FRBVE     	BRIVE-LA-GAILLARDE
BUSFR     	BUSNES
CAEFR     	CAEN
FRZAO     	CAHORS
FRCQF     	CALAIS
CALFR     	CALIGNY
CLOFR     	CALONNE RICOUART
FRCLY     	CALVI
CAMFR     	CAMBRONNE-LES-CLERMONT
FRCEQ     	CANNES
FRJCA     	CANNES
FRQYW     	CANNES
FRCCF     	CARCASSONNE
CAIFR     	CARIGNAN
CARFR     	CARQUEFOU
FRDCM     	CASTRES
CEDFR     	CEDEX
CFOFR     	CERANS-FOULLETOURTE
CERFR     	CERCY-LA-TOUR
CESFR     	CESTAS
CEYFR     	CEYZERIAT
CHLFR     	CHALEZEULE
FRXCR     	CHALONS SUR MARNE
FRCMF     	CHAMBERY
CMBFR     	CHAMBLY
CBTFR     	CHAMBORET
CHMFR     	CHAMBOST ALLIERES
CLTFR     	CHAMBRAY-LES-TOURS
CHGFR     	CHAMPAGNOLE
CHPFR     	CHAMPNIERS
CTPFR     	CHANTEPIE
CRLFR     	CHARLIEU
CDPFR     	CHASSENEUIL-DU-POITOU
CHAFR     	CHATEAU GONTIER
CHTFR     	CHATEAUDUN
FRCHR     	CHATEAUROUX
CHVFR     	CHAVANOD
FRCER     	CHERBOURG
CHEFR     	CHESNAY
FRCET     	CHOLET
CLAFR     	CLAIRVAUX-LES-LACS
CLEFR     	CLERMONT CEDEX
FRCFE     	CLERMONT-FERRAND
CLIFR     	CLICHY
FRCNG     	COGNAC
COIFR     	COIGNIERES
FRCMR     	COLMAR
COMFR     	COMMERCY
CMPFR     	COMPIEGNE
CONFR     	CONLIE
FRCVF     	COURCHEVEL
COUFR     	COURNON
FRCSF     	CREIL
CREFR     	CRETEIL
CUIFR     	CUISERY
CUSFR     	CUSSET
DACFR     	DACHSTEIN
FRDOL     	DEAUVILLE
DELFR     	DELLE CEDEX
FRDXA     	DEUX ALPES
FRDPE     	DIEPPE
FRDIJ     	DIJON
FRDNR     	DINARD
FRDLP     	DISNEYLAND PARIS
DISFR     	DISSAY
DOLFR     	DOLE
FRDLE     	DOLE
DORFR     	DORTAN
DRAFR     	DRANCY
ERLFR     	ECHIROLLES
ENNFR     	ENNERY
ENTFR     	ENTZHEIM
EPRFR     	EPERNON
EPEFR     	EPIEDS-EN-BEAUCE
EPNFR     	EPINAL 
FREPL     	EPINAL
EPIFR     	EPINOUZE
ETAFR     	ETAMPES
FREVX     	EVREUX
FRJEV     	EVRY
FAUFR     	FAUCONNIERES
FAVFR     	FAVERGES
FEIFR     	FEIGNIES
FEYFR     	FEYZIN
FRFSC     	FIGARI
FLEFR     	FLERS
FEEFR     	FLERS-EN-ESCREBIEUX
FLAFR     	FLEURY-LES-AUBRAIS
FOCFR     	FOCINE-LE-HAUT
FNTFR     	FONTAINE LE BOURG
FNBFR     	FONTAINEBLEAU
FRFRJ     	FREJUS
FREFR     	FRETIN
LILFR     	FRETIN
GAIFR     	GAILLON
FRGAT     	GAP
GARFR     	GARGES LES GONESSE
GEMFR     	GEMENOS
GENFR     	GENAY
GETFR     	GETIGNE
GLUFR     	GLUIRAS
FRGFR     	GRANVILLE
GREFR     	GRENOBLE
GRIFR     	GRIESHERIM
GROFR     	GROISSIAT
GUYFR     	GUYANCOURT
GYOFR     	GYORGY
HAIFR     	HAISNES
FRHZB     	HAZEBROUCK
HERFR     	HEROUVILLE
HESFR     	HESINGUE 
HEYFR     	HEYRON
HIRFR     	HIRSON
FRTLN     	HYERES
IBOFR     	IBOS
INGFR     	INGWILLER
ISLFR     	ISLE
ISNFR     	ISNEAUVILLE
ISSFR     	ISS LES MOULINEAUX
ISOFR     	ISSOIRE
IZEFR     	IZERNORE
JOUFR     	JOUY EN JOSAS
FRJLP     	JUAN LES PINS
JUVFR     	JUVIGNY
FRLBY     	LA BAULE-ESCOUBLAC
BRUFR     	LA BRUFFIERE
LCMFR     	LA CAPELLE-ET-MASMOLENE
LACFR     	LA CHATRE
LFBFR     	LA FERRIERE-BOCHARD
LAFFR     	LA FERTE SAINT AUBIN
FRPLG     	LA PLAGNE
LAIFR     	LA RICHARDAIS
LAOFR     	LA ROCHE SUR YON
FRLRH     	LA ROCHELLE
LARFR     	LA ROCHE-SOUS-MONTIGNY
LRSFR     	LA ROCHE-SUR-FORON
LAEFR     	LA SELLE UN LUITRE
LASFR     	LA SOUTERRAINE
LABFR     	LABPOURSE
LNGFR     	LANGEAIS
LANFR     	LANGRES
FRLAI     	LANNION
LNNFR     	LANNION
LRCFR     	LARCAY
FRLVA     	LAVAL
LAVFR     	LAVAL
LVAFR     	LAVANCIA
LBBFR     	LE BENY-BOCAGE
LEBFR     	LE BOIS ROBERT
LBGFR     	LE BOURGET 
FRCTT     	LE CASTELLET
LCHFR     	LE CHAMBON-FEUGEROLLES
LECFR     	LE CORBIER
LGQFR     	LE GRAND QUEVILLY
FRLE      	LE HAVRE
FRLEH     	LE HAVRE
LEHFR     	LE HAVRE
FRLME     	LE MANS
FRLPY     	LE PUY
FRLTQ     	LE TOUQUET
LCSFR     	LECOUSSE
LEOFR     	LEON
LEAFR     	LES ALLUETS-LE-ROI
LENFR     	LES ANDELYS
LEEFR     	LES HERBIERS
LESFR     	LES MUREAUX
FRLSO     	LES SABLES
LEVFR     	LEVALLOIS - PERRET
LIBFR     	LIBERCOURT
FRLIL     	LILLE
FRXDB     	LILLE
FRXFA     	LILLE
FRLIG     	LIMOGES
LIMFR     	LIMOGES
LIVFR     	LIVRY-GARGAN 
LOGFR     	LOGNES
LSAFR     	LONGEVILLE -LES-SAINT-AVOLD
LONFR     	LONGVIC
FRLRT     	LORIENT
LRDFR     	LOURDES
FRLDE     	LOURDES/TARBES
LOUFR     	LOUVERNE
LDBFR     	LOUVIGNE-DE-BAIS
LUCFR     	LUCE
LURFR     	LURE
FRLYN     	LYON
FRLYS     	LYON
FRXYD     	LYON
FRXYL     	LYON
FRXYV     	LYON
LYOFR     	LYON
MACFR     	MACON
MAGFR     	MAGNY VERNOIS
MAIFR     	MAILLAT
MRCFR     	MARCKOLSHEIM
MLCFR     	MARGNY-LES-COMPIEGNE
MALFR     	MARLES-LES-MINES
MRZFR     	MARNAZ
FRMRS     	MARSEILLE
FRXRF     	MARSEILLE
MARFR     	MARSEILLE
MRTFR     	MARTIGNAT
MASFR     	MASSY
MLIFR     	MAUREILLAS-LAS-ILLAS
MAZFR     	MAZAMET
MEAFR     	MEAUX
FRMVV     	MEGEVE
MELFR     	MELISEY
FRMEN     	MENDE
MENFR     	MENTHON SAINT BERNARD
MERFR     	MERU
MEYFR     	MERY
FRMZM     	METZ
METFR     	METZ
FRETZ     	METZ/NANCY
MEUFR     	MEUDON LA FORET
MYLFR     	MEYLAN
MEZFR     	MEYZIEU
MIRFR     	MIRIBEL
MSMFR     	MOELAN-SUR-MER
MOIFR     	MOIRANS EN MONTAGNE
MOSFR     	MOISSY CRAMAYEL
MONFR     	MONACO
MNVFR     	MONDEVILLE
FRMCU     	MONTLUCON
MOTFR     	MONTMIRAIL
FRMPL     	MONTPELLIER
FRXPJ     	MONTPELLIER
MLAFR     	MONTREUIL-L ARGILLE
FRMXN     	MORLAIX
MORFR     	MORLAIX
MLTFR     	MOULT
MOUFR     	MOUZON
MULFR     	MULHOUSE
MUZFR     	MUZILLAC
FRENC     	NANCY
NATFR     	NANTERRE
FRNTE     	NANTES
NANFR     	NANTES
NTTFR     	NANTIAT
NNTFR     	NANTUA
FRNVS     	NEVERS
NEYFR     	NEYRON
NIBFR     	NIBAS
FRNCE     	NICE
NICFR     	NICE
FRFNI     	NIMES
FRNIT     	NIORT
NLRFR     	NOGENT-LE-ROTROU
NOGFR     	NOGENT-SUR-VERNISSON
NOIFR     	NOISY-LE-GRAND
NOMFR     	NOMPATELIZE
OLTFR     	OLTINGUE
ORBFR     	ORBEY 
ORGFR     	ORGELET
FRORE     	ORLEANS
OREFR     	ORLEANS
ORLFR     	ORLY
ORNFR     	ORNANS
OYOFR     	OYONNAX
PALFR     	PALAISEAU
FRBVA     	PARIS
FRCDG     	PARIS
FRJDP     	PARIS
FRJPU     	PARIS
FRLBG     	PARIS
FRORY     	PARIS
FRPOX     	PARIS
PARFR     	PARIS
PRMFR     	PARMAIN
FRPUF     	PAU
PAUFR     	PAU
FRPGX     	PERIGUEUX
FRPGF     	PERPIGNAN
PIEFR     	PIERRE DE BREESE
FRPIS     	POITIERS
POTFR     	PONTARLIER
PONFR     	PONTCHATEAU
PDLFR     	PONT-DE-LARN
PORFR     	PORDIC
PREFR     	PRESLES
PRIFR     	PRINGY
FRPRP     	PROPRIANO
PUTFR     	PUTEAUX
FRUIP     	QUIMPER
RATFR     	RAMATULLE
FRRHE     	REIMS
RNSFR     	RENESCURE
FRRNS     	RENNES
FRZFJ     	RENNES
RENFR     	RENNES
RILFR     	RILLIEUX-LA-PAPE
RIOFR     	RIOZ
RISFR     	RISOUL
RIXFR     	RIXHEIM
FRRNE     	ROANNE
FRRCO     	ROCHEFORT
ROCFR     	ROCHEFORT
RLBFR     	ROCHE-LEZ-BEAUPRE
FRRDZ     	RODEZ
ROIFR     	ROISSY
RMGFR     	ROMAGNY
FRURO     	ROUEN
ROUFR     	ROUFFACH
FRRYN     	ROYAN
RUEFR     	RUEIL MALMAISON
SSCFR     	SAIL-SOUS-COUZAN
SALFR     	SAINT ALBAN LES EAUX
ASTFR     	SAINT ASTIER
SCLFR     	SAINT CLAUDE
SCVFR     	SAINT COSME EN VARAIS
SEVFR     	SAINT EGREVE
SEDFR     	SAINT ETIENNE DU BOIS
SFCFR     	SAINT FLORENT SUR CHER
SLDFR     	SAINT LAURENT DU PONT
SAIFR     	SAINT LAURENT SUR GORRE
SMAFR     	SAINT MALO 
STMFR     	SAINT MICHEL SUR MEURTH
SSVFR     	SAINT SORLIN EN VALLOIRE
FRLTT     	SAINT TROPEZ
FRXPZ     	SAINT TROPEZ
FRSYT     	SAINT YAN
STBFR     	SAINT-BRIEUC
SNTFR     	SAINT-CALUDE
SNCFR     	SAINT-CLAUDE
SMBFR     	SAINTE-MARIE-LA-BLANCHE
SGLFR     	SAINT-GEORGES-SUR-LOIRE
SLNFR     	SAINT-LEONARD-DE-NOBLAT
SANFR     	SAINT-LYE
SAMFR     	SAINT-MARCELLIN
SMCFR     	SAINT-MARTIN-DE-CRAU
SMJFR     	SAINT-MEDARD-EN-JALLES
SMMFR     	SAINT-MICHEL-SUR-MEURTHE
SPPFR     	SAINT-PIERRE-DE-PLESGUEN
STPFR     	SAINT-PRIEST
SYOFR     	SAINT-YORRE
SAVFR     	SAVIGNE-SUR-LATHAN
SCIFR     	SCIONZER
SGZFR     	SEGONZAC
SEGFR     	SEGRE
SSLFR     	SEICHES-SUR-LE-LOIR
SENFR     	SENS
SERFR     	SERQUIGNY
FRSEC     	SERRE CHEVALIER
SIGFR     	SIGNE
SILFR     	SILLE LE GUILLAUME
FRSOZ     	SOLENZARA
FRSXD     	SOPHIA ANTIPOLIS
STCFR     	ST CERE
FRSCP     	ST CREPIN
FREBU     	ST ETIENNE
FRSNR     	ST NAZAIRE
STNFR     	ST NICOLAS DALIEMONT
SATFR     	ST. AME
STEFR     	STE. HELENE DU LAC
FRSXB     	STRASBOURG
STAFR     	STRASBOURG
STRFR     	STRASBOURG
SURFR     	SURVILLIERS
THEFR     	THEILLAY
THIFR     	THIANT
FRTGF     	TIGNES
TILFR     	TILLOY LES MOFPLAIN
FRTLS     	TOULOUSE
FRXYT     	TOULOUSE
TOUFR     	TOULOUSE
TORFR     	TOURCOING
FRTUF     	TOURS
FRTNF     	TOUSSUS-LE-NOBLE
FRSBK     	TREMUSON
TRIFR     	TRILPORT
TROFR     	TROYES
VAGFR     	VAGNEY
FRVAF     	VALENCE
VLNFR     	VALENCE 
VALFR     	VALENTIGNEY
FRVNE     	VANNES
VARFR     	VARAVILLE
VENFR     	VENETTE
VEIFR     	VENISSIEUX
VEBFR     	VERBERIE
VERFR     	VERDUN
VSAFR     	VERNEUIL-SUR-AVRE
VRQFR     	VERQUIGNEUL
VLBFR     	VERRIERES-LE-BUISSON
FRVHY     	VICHY
VRZFR     	VIERZON
VIEFR     	VILLEBON-SUR-YVETTE
VDAFR     	VILLENEUCVE-DASCQ
VLPFR     	VILLEPREUX
VILFR     	VILLERS-SAINT-PAUL
VREFR     	VIRE
VIRFR     	VIRY
VITFR     	VITRE
VSSFR     	VITRY-SUR-SEINE
FRVTL     	VITTEL
VTLFR     	VITTEL
VIVFR     	VIVIERS-DU-LAC
VOIFR     	VOIRON
WASFR     	WASQUEHAL
WATFR     	WATTIGNIES
YUTFR     	YUTZ
YVEFR     	YVELINES