IDAEG     	AEK GODANG
IDARD     	ALOR ISLAND
IDAHI     	AMAHAI
IDAMQ     	AMBON
IDAGD     	ANGGI
IDAAS     	APALAPSILI
IDARJ     	ARSO
IDAKQ     	ASTRAKSETRA
IDABU     	ATAMBUA
IDAUT     	ATAURO
IDAYW     	AYAWASI
IDBXB     	BABO
IDBXD     	BADE
IDBJW     	BAJAWA
IDBPN     	BALIKPAPAN
IDNAF     	BANAINA
IDBTJ     	BANDA ACEH
IDNDA     	BANDANAIRA
IDTKG     	BANDAR LAMPUNG
IDBDO     	BANDUNG
IDBDJ     	BANJARMASIN
BATID     	BATAM
IDBTH     	BATAM
IDBXM     	BATOM
IDBTW     	BATU LICIN
IDBUW     	BAUBAU
BEKID     	BEKASI
IDBKS     	BENGKULU
IDBJK     	BENJINA
IDBIK     	BIAK
IDBMU     	BIMA
IDNTI     	BINTUNI
IDBUI     	BOKONDINI
IDBJG     	BOLAANG
IDBXT     	BONTANG
IDBYQ     	BUNYU
IDUOL     	BUOL
IDCPF     	CEPU
CIBID     	CIBATU
CIKID     	CIKARANG
IDCXP     	CILACAP
IDCBN     	CIREBON
IDDRH     	DABRA
IDDTD     	DATADAWAI
IDDPS     	DENPASAR, BALI
IDDUM     	DUMAI
IDELR     	ELELIM
IDEWI     	ENAROTALI
IDENE     	ENDE
IDEWE     	EWER
IDFKQ     	FAK FAK
IDGAV     	GAG ISLAND
IDGLX     	GALELA
IDGEB     	GEBE
IDGTO     	GORONTALO
IDGNS     	GUNUNGSITOLI
IDILA     	ILLAGA
IDIUL     	ILU
IDINX     	INANWATAN
SAMI     	INDONESIA
IDCGK     	JAKARTA
IDHLP     	JAKARTA
IDJKT     	JAKARTA
IDPCB     	JAKARTA
JAKID     	JAKARTA
IDDJB     	JAMBI
IDDJJ     	JAYAPURA
IDKNG     	KAIMANA
IDKBX     	KAMBUAYA
IDKCD     	KAMUR
IDKWB     	KARIMUNJAWA
IDKBF     	KARUBAGA
IDKAZ     	KAU
IDKEQ     	KEBAR
IDKEA     	KEISAH
IDLLN     	KELILA
IDKLQ     	KELUANG
IDKDI     	KENDARI
IDKEI     	KEPI
IDKRC     	KERINCI
IDKTG     	KETAPANG
IDKMM     	KIMAM
IDKOX     	KOKONAO
IDKCI     	KON
IDKOD     	KOTABANGUN
IDKBU     	KOTABARU
IDKOE     	KUPANG
IDLBJ     	LABUAN BAJO
IDLAH     	LABUHA
IDLUV     	LANGGUR
IDLKA     	LARANTUKA
IDLHI     	LEREH
IDLWE     	LEWOLEBA
IDLSX     	LHOK SUKON
IDLSW     	LHOKSUMAWE
IDLPU     	LONG APUNG
IDLBW     	LONG BAWAN
IDLYK     	LUNYUK
IDLUW     	LUWUK
IDMLG     	MALANG
MALID     	MALANG
IDMPT     	MALIANA
IDMJU     	MAMUJU
IDMDC     	MANADO
IDMAL     	MANGOLE
IDMJY     	MANGUNJAYA
IDMKW     	MANOKWARI
IDMSI     	MASALEMBO
IDMXB     	MASAMBA
IDMWK     	MATAK
IDAMI     	MATARAM
IDMOF     	MAUMERE
IDMES     	MEDAN
IDMNA     	MELANGGUANE
IDMKQ     	MERAUKE
IDRDE     	MERDEY
IDMEQ     	MEULABOH
IDMDP     	MINDIPTANA
IDONI     	MOANAMANI
IDMPC     	MUKO-MUKO
IDLII     	MULIA
IDMUF     	MUTING
IDNBX     	NABIRE
IDNAH     	NAHA
IDNAM     	NAMLEA
IDNPO     	NANGAPINOH
IDNTX     	NATUNA RANAI
IDFOO     	NUMFOOR
IDNNX     	NUNUKAN
IDOBD     	OBANO
IDOEC     	OCUSSI
IDOKQ     	OKABA
IDOKL     	OKSIBIL
PADID     	PADALARANG
IDPDG     	PADANG
IDPKY     	PALANGKARAYA
IDPLM     	PALEMBANG
IDPBW     	PALIBELO
IDPLW     	PALU
IDPKN     	PANGKALANBUUN
IDPGK     	PANGKALPINANG
IDPPR     	PASIR PANGARAYAN
PASID     	PASURUAN
IDPKU     	PEKANBARU
IDPDO     	PENDOPO
IDOTI     	PITU, MOROTAI ISLAN
IDPUM     	POMALA
IDPNK     	PONTIANAK
IDPSJ     	POSO
PEMI     	PT EDS MANUFACTURING
JAI     	PT JATAM AUTOCOMP
IDPPJ     	PULAU PANJANG
IDPWL     	PURWOKERTO
IDPSU     	PUTUSSIBAU
IDRAQ     	RAHA
IDRSK     	RANSIKI
IDRGT     	RENGAT
IDRKI     	ROKOT
IDRTI     	ROTI
IDRTG     	RUTENG
IDSBG     	SABANG
IDSRI     	SAMARINDA
IDSMQ     	SAMPIT
IDSQN     	SANANA
IDSGQ     	SANGGATA
IDSAE     	SANGIR
IDZRM     	SARMI
IDSXK     	SAUMLAKI
IDSAU     	SAWU
IDSRG     	SEMARANG
IDSEH     	SENGGEH
IDZEG     	SENGGO
IDSZH     	SENIPAH
IDZRI     	SERUI
SIDID     	SIDOARJO
IDNKD     	SINAK
IDSIQ     	SINGKEP
IDSQG     	SINTANG
IDRKO     	SIPORA
IDSOC     	SOLO CITY
IDSQR     	SOROAKO
IDSOQ     	SORONG
IDZKL     	STEENKOOL
IDUAI     	SUAI
SURID     	SUBABAYA
IDSWQ     	SUMBAWA
IDSUP     	SUMENEP
IDSEQ     	SUNGAI PAKNING
IDSUB     	SURABAYA
SUBID     	SURABAYA
IDTAX     	TALIABU
IDTMC     	TAMBOLAKA
IDTTR     	TANA TORAJA
IDTNB     	TANAH GROGOT
IDTMH     	TANAHMERAH
TANID     	TANGERANG
IDTJB     	TANJUNG BALAI
IDTJQ     	TANJUNG PANDAN
IDTNJ     	TANJUNG PINANG
IDBEJ     	TANJUNG REDEP
IDTJS     	TANJUNG SELOR
IDTJG     	TANJUNG WARUKIN
IDTPK     	TAPAKTUAN
IDTRK     	TARAKAN
IDTIM     	TEMBAGAPURA
IDTXM     	TEMINABUAN
IDTTE     	TERNATE
IDTMY     	TIOM
IDTLI     	TOLITOLI
IDTBM     	TUMBANG SAMBA
IDUBR     	UBRUB
IDUPG     	UJUNG PANDANG
IDVIQ     	VIQUEQUE
IDWET     	WAGETHE
IDWGP     	WAINGAPU
IDWMX     	WAMENA
IDWAR     	WARIS
IDWSR     	WASIOR
WJAID     	WEST JAVA
IDJOG     	YOGYAKARTA
IDUGU     	ZUGAPA