ACHIN     	ACHAMPET
INIXA     	AGARTALA
INAGX     	AGATTI ISLAND
INAGR     	AGRA
AHEIN     	AHMEDABAD
INAMD     	AHMEDABAD
AHMIN     	AHMEDNAGAR
INAJL     	AIZAWL
INAKD     	AKOLA
INIXD     	ALLAHABAD
INIXV     	ALONG
AMBIN     	AMBATTUR
INATQ     	AMRITSAR
ANJIN     	ANJUR
ARPIN     	ARUNACHAL PRADESH
AURIN     	AURANGABAD
INIXU     	AURANGABAD
INIXB     	BAGDOGRA
INRGH     	BALURGHAT
BANIN     	BANGALORE
INBLR     	BANGALORE
INBEK     	BARELI
BARIN     	BARODA
BAWIN     	BAWAL
BEGIN     	BEGUR HOBLI
INIXG     	BELGAUM
INBEP     	BELLARY
BENIN     	BENGALURU
BHAIN     	BHARUCH
INBUP     	BHATINDA
INBHU     	BHAVNAGAR
INBHO     	BHOPAL
INBBI     	BHUBANESWAR
INBHJ     	BHUJ
INKUU     	BHUNTAR KULLU.
INBKB     	BIKANER
INPAB     	BILASPUR
BOMIN     	BOMBAY
CALIN     	CALCUTTA
INCBD     	CAR NICOBAR
CARIN     	CARDA
CHAIN     	CHANDIGARH
INIXC     	CHANDIGARH
CHEIN     	CHENNAI
INMAA     	CHENNAI/MADRAS
CHIIN     	CHINCHWAD
COCIN     	COCHIN
COIIN     	COIMBATORE
INCJB     	COIMBATORE
INCOH     	COOCH BEHAR
INCDP     	CUDDAPAH
INNMB     	DAMAN
INDAE     	DAPARIZO
INDAI     	DARJEELING
INDED     	DEHRA DUN
DELIN     	DELHI
INDEP     	DEPARIZO
DEVIN     	DEVANAHALLI
INDBD     	DHANBAD
INDHM     	DHARAMSALA
INDIB     	DIBRUGARH
INDMU     	DIMAPUR
INDIU     	DIU
DODIN     	DODDABALLAPURA
FARIN     	FARIDABAD
INGAU     	GAWAHATI
INGAY     	GAYA
INGOI     	GOA
INGOP     	GORAKHPUR
GTNIN     	GREATER NOIDA
GJAIN     	GUJARAT
GUJIN     	GUJARET
INGUX     	GUNA
GURIN     	GURGAON
INGWL     	GWALIOR
HDRIN     	HARIDWAR
HARIN     	HARYANA
HMPIN     	HIMACHEL PRADESH
INHSS     	HISSAR
HOSIN     	HOSHIARPUR
HSUIN     	HOSUR
HOWIN     	HOWRAH
INHBX     	HUBLI
HYDIN     	HYDERABAD
INHYD     	HYDERABAD
INIMF     	IMPHAL
INDIN     	INDORE
INIDR     	INDORE
IRUIN     	IRUNGATTUKOTTAI
INJLR     	JABALPUR
JAGIN     	JAGADHRI
INJGB     	JAGDALPUR
INJAI     	JAIPUR
JAIIN     	JAIPUR
INJSA     	JAISALMER
INIXJ     	JAMMU
INJGA     	JAMNAGAR
INIXW     	JAMSHEDPUR
JAMIN     	JAMSHEDPUR
JAWIN     	JAWAHARLAL NEHRU
INPYB     	JEYPORE
INJDH     	JODHPUR
INJRH     	JORHAT
INIXH     	KAILASHAHAR
INIXQ     	KAMALPUR
KANIN     	KANCHIPURAM
INIXY     	KANDLA
INKNU     	KANPUR
KARIN     	KARATAKA
KNTIN     	KARNATAKA
KATIN     	KATARGAM
INIXK     	KESHOD
KESIN     	KESNAND
KHAIN     	KHADKI
INHJR     	KHAJURAHO
INIXN     	KHOWAI
INCOK     	KOCHI
KOCIN     	KOCHI
INKLH     	KOLHAPUR
KOLIN     	KOLHAPUR
INCCU     	KOLKATA
KKAIN     	KOLKATA
INKTU     	KOTA
INCCJ     	KOZHIKODE
INIXL     	LEH
INIXI     	LILABARI
INLKO     	LUCKNOW
INLUH     	LUDHIANA
LUDIN     	LUDHIANA
INIXM     	MADURAI
MADIN     	MADURAI
MDRIN     	MADURANTHAKAM
MAHIN     	MAHARASHTRA
INLDA     	MALDA
MANIN     	MANESAR
INIXE     	MANGALORE
MARIN     	MARAIMALAINAGAR
MEHIN     	MEHSANA
METIN     	METAGALLI
INMOH     	MOHANBARI
INBOM     	MUMBAI
MUMIN     	MUMBAI
MUNIN     	MUNDRA
INMZA     	MUZAFFARNAGAR
INMZU     	MUZAFFARPUR
MYSIN     	MYSORE
INNAG     	NAGPUR
INNDC     	NANDED
INISK     	NASIK
INDEL     	NEW DELHI
NEWIN     	NEW DELHI
INNVY     	NEYVELI
NHAIN     	NHAVA SHEVA
NOIIN     	NOIDA
INOMN     	OSMANABAD
PNCIN     	PANCHKULA
PANIN     	PANIPAT
INPGH     	PANTNAGAR
PAVIN     	PANVEL
INIXT     	PASIGHAT
INIXP     	PATHANKOT
INPAT     	PATNA
PERIN     	PERAMBUR
PHAIN     	PHASE
PIMIN     	PIMPRI-CHINCHWAD
PININ     	PINE
INPNY     	PONDICHERRY
INPBD     	PORBANDAR
INIXZ     	PORT BLAIR
INPNQ     	PUNE
PUNIN     	PUNE
INPUT     	PUTTAPARTHI
INRPR     	RAIPUR
INRJA     	RAJAHMUNDRY
RAJIN     	RAJKOT
INRJI     	RAJOURI
INRMD     	RAMAGUNDAM
INIXR     	RANCHI
RNPIN     	RANIPET
RANIN     	RANJANGAON
INRTC     	RATNAGIRI
RATIN     	RATNAGIRI
INREW     	REWA
INRRK     	ROURKELA
RUDIN     	RUDRAPUR
INRUP     	RUPSI
SAFIN     	SAFARA
SAHIN     	SAHAKARA NAGAR
INSXV     	SALEM
SARIN     	SARIGAM
SATIN     	SATARA
INTNI     	SATNA
INSHL     	SHILLONG
INSSE     	SHOLAPUR
INIXS     	SILCHAR
INSLV     	SIMLA
SININ     	SINNAR
SOLIN     	SOLAPUR
INSXR     	SRINAGAR
SRIIN     	SRIPERUMBUDUR
INSTV     	SURAT
SURIN     	SURAT
TALIN     	TALEGAON DABHADE
TAMIN     	TAMIL NADU
INTEZ     	TEZPUR
INTEI     	TEZU
INTJV     	THANJAVUR
THEIN     	THENI
INTRZ     	TIRUCHIRAPALLY
INTIR     	TIRUPATI
TIRIN     	TIRUPPUR
INTRV     	TRIVANDRUM
INTCR     	TUTICORIN
INUDR     	UDAIPUR
INBDQ     	VADODARA
INVNS     	VARANASI
INVGA     	VIJAYAWADA
INVTZ     	VISHAKHAPATNAM
INWGC     	WARANGAL
TYA     	YAZAKI TATA INDIA
INZER     	ZERO