ACOSA     	ACOSA
ACUMX     	ACUNA
AGAMX     	AGUA PRIETA
AGUMX     	AGUACALIENTES
AUGMX     	AGUASCALIENTES
ALPHA     	ALPHA
ALTMX     	ALTAMIRA
ALVMX     	ALVARO OBREGON
AMOMX     	AMOZOC
AMSA     	AMSA
AEAMX     	APASEO EL ALTO
APAMX     	APASEO EL GRANDE
APIMX     	APIZACO
APOMX     	APODACA
ARTMX     	ARTEAGA
ATIMX     	ATIZAPA de ZARAGOZA
ATLMX     	ATLACOMULCO
AYAMX     	AYALA
AZCMX     	AZCAPOTZALCO
BPSA     	BAPSA
BARMX     	BARRIO
BMAMX     	BELLAVISTA MESA DE ARIZPE
BENMX     	BENITO JUAREZ
BERMX     	BERNARDO QUINTA
BOCMX     	BOCA DEL RIO
CAJMX     	CAJEME
CANMX     	CANCUN
MXCUN     	CANCUN
CARMX     	CARDENAS
CAEMX     	CARRETERA
CEDMX     	CEDRAL
CELMX     	CELAYA
CENMX     	CENEGA DE FLORES
CHAMX     	CHACHAPA
CHLMX     	CHALCO
CHIMX     	CHIHUAHUA
CIEMX     	CIENEGA DE FLORES
CIRMX     	CIRCUNVALACION NORTE
CIUMX     	CIUDAD ACUNA
CIJMX     	CIUDAD JUAREZ
CNEMX     	CIUDAD NEZAHUALCOYOTL
CCOMX     	COACALCO DE BERRIZABAL
COAMX     	COAHUILA
COLMX     	COLIMA
CODMX     	CORDOBA
CORMX     	CORONANGO
CRGMX     	CORREGIDORA
COTMX     	CORTAZAR
COYMX     	COYACAN
CUJMX     	CUAJIMALPA DE MOR
CUUMX     	CUAUHTEMOC
CTLMX     	CUAUTITLAN
CAUMX     	CUAUTITLAN IZCALLI
CUAMX     	CUAUTLA
CUTMX     	CUAUTLANCINGO
CUEMX     	CUERNAVACA
CULMX     	CULIACAN
DELMX     	DELEG
DEEMX     	DELEGACION VENUSTIANO CARRANZA
DFDMX     	DISTRITO FEDERAL
DURMX     	DURANGO
ELCMX     	EL CARMEN
ELDMX     	EL DIEZMO
ELLMX     	EL LECHUGAL
ELMMX     	EL MARQUES QUERETARO
EMDMX     	EL MIRADOR
ELSMX     	EL SALTO JALISCO
ESVMX     	EL SALVADOR
EMPMX     	EMPALME
ENSMX     	ENSENADA
ESCMX     	ESCOBEDO
ESTMX     	ESTADO DE MEXICO
ETCMX     	ETCHOJA
FREMX     	FRESNILLO
FROMX     	FRONTERA
GARMX     	GARCIA
GAZMX     	GARZA GARCIA
GENMX     	GENERAL ESCOBEDO
GOMMX     	GOMEZ PALACIO
GRAMX     	GRAL ESCOBEDO
GUDMX     	GUADALAJARA
GUADA     	GUADALUPE
GUPMX     	GUADALUPE
GUAMX     	GUANAJUATO
GUYMX     	GUAYMAS
HERMX     	HERMOSILLO
HIDMX     	HIDALGO
HUAMX     	HUAMANTLA
HUEMX     	HUEHUETOCA
HUJMX     	HUEJOTZINGO
HUCMX     	HUICHAPAN
HUMMX     	HUIMILPAN
IRAMX     	IRAPUATO
ISLMX     	ISLA NATIVIDAD
IXTMX     	IXTLAHUACA
IZTMX     	IZTAPALAPA
JACMX     	JALCOMULCO
JALMX     	JALISCO
JBAMX     	JARDIN BALBUENA
JARMX     	JARDINES DEL VIRREY
JESMX     	JESUS MARIA
JIUMX     	JIUEPEC
JUTMX     	JIUTEPEC
JUAMX     	JUAREZ
LPIMX     	LA PILA
LDMMX     	LAGOS DE MORENO
LAGMX     	LAGUNA DE SAN VICENTE
LAAMX     	LAS AGUILAS
LASMX     	LAS PINTAS
LENMX     	LEON
LEOMX     	LEON
LERMX     	LERMA
LINMX     	LINARES
LOCMX     	LOS CABOS
MACSA     	MACSA
MADMX     	MADERO
MANMX     	MANZANILLO
MATMX     	MATAMORAS
MAZMX     	MAZATLAN
MERMX     	MERIDA
METMX     	METEPEC
MCLMX     	MEXICALI
MEXMX     	MEXICO CITY
MXMEX     	MEXICO CITY
MDCMX     	MEXQUITIC DE CARMONA
HILMX     	MIGUEL HIDALGO
MIRMX     	MIRANDA EL MARQUES
MOCMX     	MONCLOVA
MONMX     	MONTERREY
MORMX     	MORELIA
MOEMX     	MORELOS
NAUMX     	NAUCALPAN
NAV     	NAVOJOA
NOGMX     	NOGALES
NUAMX     	NUEVA INDUSTRIAL VALLEJO
NUEMX     	NUEVO LAREDO
NUVMX     	NUEVO LEON
NVOMX     	NVO LAREDO
OBRMX     	OBREGON
OJOMX     	OJOCALIENTE
ORIMX     	ORIZABA
PALMX     	PALMAS POLANCO
PANMX     	PANTITLAN
PZCMX     	PANZACOLA
PAPMX     	PAPALOTLA DE XICOHTENCATI
PESMX     	PESQUERIA
PIEMX     	PIEDRAS NEGRAS
POLMX     	POLOTITLAN
PONMX     	PONCITLAN
PUEMX     	PUEBLA
PUNMX     	PUNTA CHIVATO
PURMX     	PURISIMA DEL RINC
PNZMX     	PZNZACOLA
QUEMX     	QUERETARO
RAMMX     	RAMOS ARIZPE COAHUILA
RESMX     	RESURRECCION
REYMX     	REYNOSA TAMAULIPAS
RIOMX     	RIO BRAVO
ROMMX     	ROMITA
ROSMX     	ROSALES
SHAMX     	SAHAGUN CITY CENTRE
SAVMX     	SALINAS VICTORIA
SALMX     	SALTILLO
SDTMX     	SAN ANDRES ATOTO
SAHMX     	SAN ANDRES CHOLULA
SAFMX     	SAN FRANCISCO DE LOS ROMO
SJDMX     	SAN JOSE DEL CABO
SJOMX     	SAN JOSE ITURBIDE
SJVMX     	SAN JOSE VILLA DE ALLENDE
SJUMX     	SAN JUAN CUAUTLANCINGO
SDLMX     	SAN JUAN DEL RIO
SNLMX     	SAN LORENZO
SANMX     	SAN LUIS POTOSI
SLRMX     	SAN LUIS RIO COLORADO
SMCMX     	SAN MARCOS
SAMMX     	SAN MARTIN TEXMELUCAN
MIGMX     	SAN MIGUEL
SMAMX     	SAN MIGUEL DE ALLENDE
SMIMX     	SAN MIGUEL XOXTLA
SNIMX     	SAN NICOLAS DE GARZA
SAGMX     	SAN NICOLAS DE LOS GARZA
SPOMX     	SAN PEDRO
SPGMX     	SAN PEDRO GARZA
SAPMX     	SAN PEDRO SULO
STAMX     	SANTA ANITA
SACMX     	SANTA CATARINA
SATMX     	SANTA FE
SARMX     	SANTA ROSA
SRJMX     	SANTA ROSA JAUREGUI
SAAMX     	SANTA TERESA
STGMX     	SANTIAGO
SDQMX     	SANTIAGO DE QUERETARO
STTMX     	SANTIAGO TEANGUISTENCO
SILMX     	SILAO
SINMX     	SINALOA
SOLMX     	SOLEDAD DE GRACIANO SANCHEZ
SLDMX     	SOLIDARIDAD
SONMX     	SONORA
TACMX     	TACUBA
TAMMX     	TAMAULIPAS
TAXMX     	TAXCO
TCAMX     	TECATE
TECMX     	TECOMAN
TEHMX     	TEHAUCAN
TEPMX     	TEPOTZOTLAN
TERMX     	TERRENATE
TETMX     	TETLA
TDLMX     	TETLA DE LA SOLIDARIDAD
TIJMX     	TIJUANA
TIZMX     	TIZAYUCA
TLHMX     	TLAHUAC
TLJMX     	TLAJOMULCO
TPTMX     	TLALNEPANTLA DE BAZ
TLNMX     	TLANEPANTLA
TLQMX     	TLAQUEPAQUE
TLAMX     	TLAXCALA
TLXMX     	TLAXCO
TOLMX     	TOLUCA
TONMX     	TONALA
TORMX     	TORREON
TOTMX     	TOTOTLAN
TPBUE     	TPBUE
TULMX     	TULTITLAN EDO
TUXMX     	TUXTLA GUTIERR
VELMX     	VELLEHERMOSO
VENMX     	VENUSTIANO CARRANZA
VERMX     	VERACRUZ
VICMX     	VICTORIA
VDPMX     	VILLA DE POZOS
VILMX     	VILLA DE REYES
VDTMX     	VILLA DE TEZONTEP
VIAMX     	VILLAGRAN
XOCMX     	XOCHIMILCO
YARMX     	YARMEX
SON     	YARMX
PEDSA     	YNAT PEDSA
ZACMX     	ZACATECAS
ZAPMX     	ZAPOPAN
ZDLMX     	ZAPOTLAN DEL REY
ZEMMX     	ZEMPOALA