PHSFE     	ACALA
PHSJI     	ACALA
PHCRK     	ANGELES CITY
PHEUQ     	ANTIQUE
PHBCD     	BACOLOD
PHBNQ     	BAGANGA
BAGPH     	BAGUIO
PHBQA     	BALER
PHBSO     	BASCO
BATPH     	BATANGAS CITY
PHBPH     	BISLIG
BUGPH     	BUGO
PHUSU     	BUSUANGA
PHBXU     	BUTUAN
CAGPH     	CAGAYAN DE ORO
PHCGY     	CAGAYAN DE ORO
PHCDY     	CAGAYAN DE SULU
CALPH     	CALAMBA
PHCYP     	CALBAYOG
PHCGM     	CAMIGUIN
PHCRM     	CATARMAN
PHMPH     	CATICLAN
PHCYZ     	CAUAYAN
CAVPH     	CAVITE
PHSGL     	CAVITE CITY
PHCEB     	CEBU
COTPH     	CITY OF TAGUIG
PHXCN     	CORON
PHCBO     	COTABATO
PHCUJ     	CULION
PHCYU     	CUYO
PHDTE     	DAET
DAVPH     	DAVAD CITY
PHDVO     	DAVAO
PHDPL     	DIPOLOG
PHDGT     	DUMAGUETE
EMI       	EDS MANUFACTURING
PHGES     	GENERAL SANTOS
PHMNL     	GOMEZ PALACIO
PHIGN     	ILIGAN
PHILO     	ILOILO
IMUPH     	IMUS
PHIPE     	IPIL
PHENI     	IRAPUATO
PHJOL     	JOLO
PHKLO     	KALIBO
LAGPH     	LAGUNA
PHLAO     	LAOAG
PHLGP     	LEGAZPI
PHLBX     	LUBANG
PHNCP     	LUZON IS
MALPH     	MABALACAT
MAKPH     	MAKATI
PHMLP     	MALABANG
PHMBO     	MAMBURAO
MADPH     	MANDALUYONG
MANPH     	MANILA
PHXMA     	MARAMAG
PHMRQ     	MARINDUQUE
PHMBT     	MASBATE
PHMXI     	MATI
PHWNP     	NAGA
PHOMC     	ORMOC
PHOZC     	OZAMIS CITY
PHPAG     	PAGADIAN
PPGPH     	PAMPANGA
PARPH     	PARANAQUE
PASPH     	PASAY
PSCPH     	PASIG CITY
PINPH     	PINAG KAISAHAN
PHPPS     	PUERTO PRINCESA
QUEPH     	QUEZON CITY
PHRXS     	ROXAS CITY
ROSPH     	RPSARIO
SAMPH     	SAN MIGUEL
PHSGS     	SANGA SANGA
PHNSP     	SANGLEY POINT
SANPH     	SANTA ROSA
PHSSV     	SIASI
PHICO     	SICOGON ISLAND
PHXSO     	SIOCON
PHSUG     	SURIGAO
PHTBH     	TABLAS
PHTAC     	TACLOBAN
PHTAG     	TAGBILARAN
PHTGB     	TAGBITA
PHTDG     	TANDAG
PHTWT     	TAWITAWI
PHRZP     	TAYTAY SANDOVAL
PHTUG     	TUGUEGARAO
PHVRC     	VIRAC
YTM       	YAZAKI TORRES LAGUNA
PHZAM     	ZAMBOANGA