SEAGH     	ANGELHOLM/HELSINGBO
SEJHE     	ANGELHOLM/HELSINGBO
SEXYH     	ANGELHOLM/HELSINGBO
SEXYQ     	ANGELHOLM/HELSINGBO
ARJSE     	ARJEPLOG
SEAJR     	ARVIDSJAUR
BORSE     	BORAS
SEBLE     	BORLANGE
SEXYB     	BORLANGE/FALUN
BRESE     	BREDARYD
BROSE     	BROMMA
EKSSE     	EKSJO
SEXWQ     	ENKOPING
ESKSE     	ESKILSTUNA
SEEKT     	ESKILSTUNA
SEXYM     	FALKENBERG
SEXYI     	FLEN
FORSE     	FORSHEDA
FRESE     	FREDRIKSBERGSGATAN
SEGEV     	GALLIVARE
SEGVX     	GAVLE
GOTSE     	GOTEBORG
GOHSE     	GOTHENBURG
SEGOT     	GOTHENBURG
SEGSE     	GOTHENBURG
SEXWL     	GOTHENBURG
HAGSE     	HAGERSTEN
HGFSE     	HAGFORS
SEHFS     	HAGFORS
SEHAD     	HALMSTAD
SEXWP     	HASSLEHOLM
SEXXU     	HEDEMORA
SEHMV     	HEMAVAN
HERSE     	HERRLJUNGA
SEXYC     	HERRLJUNGA
HILSE     	HILLERSTORP
HOGSE     	HOSANAS
SEHUV     	HUDIKSVALL
SEHLF     	HULTSFRED
SEIDB     	IDRE
JAESE     	JAERFAELLA
JONSE     	JONKOPING
SEKLR     	KALMAR
SEXYO     	KARLSHAMN
SEKSK     	KARLSKOGA
SEKSD     	KARLSTAD
SEXXK     	KATRINEHOLM
SEKRN     	KIRUNA
KNISE     	KNIVSTA
SEKRF     	KRAMFORS
KRISE     	KRISTIANSTAD
SEKID     	KRISTIANSTAD
SEXYN     	KRISTINEHAMN
LAHSE     	LAHOLM
LANSE     	LANDSKRONA
SEJLD     	LANDSKRONA
LIDSE     	LIDKOPING
SELDK     	LIDKOPING
SELPI     	LINKOPING
LJUSE     	LJUNG
SELLA     	LULEA
SELYC     	LYCKSELE
MALSE     	MALMO
MMA       	Malmo
SEJMM     	MALMO
SEMMX     	MALMO
SEXFR     	MALMO
MARSE     	MARSTA
NRASE     	NORA
SENRK     	NORRKOPING
SEXWZ     	NYKOPING
NYNSE     	NYNASHAMN
SEORB     	OREBRO
SEOER     	ORNSKOLDSVIK
SEOSK     	OSKARSHAMN
OSTSE     	OSTERSUND
SEPJA     	PAJALA
PITSE     	PITEA
SEXZQ     	RAIL
SERNB     	RONNEBY
SEXWK     	RONNEBY
SEXYX     	SALA
SDVSE     	SANDVIKEN
SESFT     	SKELLEFTEA
SEKVB     	SKOVDE
SLASE     	SLAGNAS
SESOO     	SODERHAMN
SEJSO     	SODERTALJE
SEXEZ     	SODERTALJE
SOESE     	SODERTALJE
SODSE     	SODRA VI
SOVSE     	SODRA VIKA 
SEXYU     	SOLVESBORG
SEARN     	STOCKHOLM
SENYO     	STOCKHOLM
SEVST     	STOCKHOLM
STOSE     	STOCKHOLM
SESQO     	STORUMAN
SESDL     	SUNDSVALL
SEEVG     	SVEG
SVESE     	SVENLJUNGA
SEMXX     	TEPIC
TIDSE     	TIDAHOLM
TORSE     	TORSAS
SETYF     	TORSBY
TRESE     	TRELLEBORG
SETHN     	TROLLHATTAN
TROSE     	TROLLHATTAN
TUMSE     	TUMBA
UDDSE     	UDDEVALLA
SEUME     	UMEA
SEVXO     	VäXJö
VARSE     	VARGARDA
VASSE     	VASTERAS
SEVVK     	VASTERVIK
VERSE     	VERNAMO
SEVHM     	VILHELMINA
SEVBY     	VISBY